SO /Users/fholwerd/Documents/Codam_Core_Curriculum/cub3d/textures/stone_bricks.png
NO /Users/fholwerd/Documents/Codam_Core_Curriculum/cub3d/textures/obsidian.png
WE /Users/fholwerd/Documents/Codam_Core_Curriculum/cub3d/textures/stone.png
EA /Users/fholwerd/Documents/Codam_Core_Curriculum/cub3d/textures/nether_bricks.png

F 0,102,0
C 0,70,200

11111
11E011
 110011
  110011
   110011
    110011
     110011
      110011
       110011
        110011
         110011
          110011
           110011
            110011
             110011
              110011
               110011
                110011
                 11111