SO /Users/fholwerd/Documents/Codam_Core_Curriculum/cub3d/textures/stone_bricks.png
NO /Users/fholwerd/Documents/Codam_Core_Curriculum/cub3d/textures/obsidian.png
WE /Users/fholwerd/Documents/Codam_Core_Curriculum/cub3d/textures/stone.png
EA /Users/fholwerd/Documents/Codam_Core_Curriculum/cub3d/textures/nether_bricks.png

F 0,102,0
C 0,70,200

111111111111111111111111111111111111111
1S1000000000000000000000000000000000001
101011111111111111111111111111111111101
101010000000000000000000000000000000101
101010111111111111111111111111111110101
101010100000000000000000000000000010101
101010101111111111111111111111111010101
101010100000000000000000000000001010101
101010111111111111111111111111111010101
101010000000000000000000000000000010101
101011111111111111111111111111111110101
101000000000000000000000000000000000101
101111111111111111111111111111111111101
100000000000000000000000000000000000001
111111111111111111111111111111111111111